2,0,1,0,0,0,1,0,0,0
0,0,1,0,1,0,1,0,1,0
0,1,0,0,1,0,0,0,1,5
0,0,0,1,0,0,1,0,0,0
1,1,0,0,0,1,0,0,0,2
6,0,0,1,0,0,0,1,0,0
